################################
#1............................%#
#..............................#
#......*................*......#
#.....***..............***.....#
#......*................*......#
#...............*..............#
#..............................#
#..............................#
#...............*..............#
#......*................*......#
#.....***..............***.....#
#......*................*......#
#..............................#
#%............................2#
################################