####################
#..................#
#.**...............#
#...*........**....#
#....*.............#
#........**........#
#..................#
#........**........#
#.............*....#
#....**........*...#
#...............**.#
#..................#
####################