####################
#.**...............#
#...*........**....#
#....*.............#
#........**........#
#..................#
#..................#
#........**........#
#.............*....#
#....**........*...#
#...............**.#
####################