########################
#.*..................*.#
#......................#
#....*............*....#
#......................#
#........*....*........#
#......................#
#......................#
#........*....*........#
#......................#
#....*............*....#
#......................#
#.*..................*.#
########################