########################
#.*..................*.#
#....*............*....#
#......................#
#........*....*........#
#......................#
#........*....*........#
#......................#
#....*............*....#
#.*..................*.#
########################