#######################
#.....................#
#...**...........**...#
#.....................#
#..*...............*..#
#........*...*..........#
#.....................#
#.....................#
#........*...*..........#
#..*...............*..#
#.....................#
#...**...........**...#
#.....................#
#######################